###########################################################
#                                                         #
#                                                         #
#  #  #  #  #  #  #  #  #    #    #    #    #    #        #
#                                                         #
#                                                         #
#  #  #  #  #  #  #  #  #                                 #
#                                                         #
#                                                         #
#  #  #  #  #  #  #  #  #                                 #
#                                                         #
#                                                         #
#  #  #  #  #  #  #  #  #                                 #
#                                                         #
#                                                         #
#  #  #  #  #  #  #  #  #    #    #    #    #    #        #
#                                                         #
#                                                         #
#  #  #  #  #  #  #  #  #    #    #    #    #    #        #
#                                                         #
#                                                         #
#  #  #  #  #  #  #  #  #    #    #    #    #    #        #
###########################################################

